#############
#####.......#
####......#.#
###.......#.#
#....########
#..........##
#..........##
#..#.########
##.........@#
#############