#############
#########..##
########...##
#####......##
####..#....##
###..#.#.####
##..#..#...##
#..#..#.##.##
#@#........##
#############