#############
########...##
#######....##
#####......##
####..#....##
###..#.#.####
##..#..#...##
#..#....##.##
#@#...#....##
#############