#############
#@...#......#
###..#..##..#
#...........#
#.#........##
#.#..##.....#
#.#.......#.#
#.#.........#
#....#...#..#
#############