#############
#.....#.....#
#.###.#.#.#.#
#.#.........#
#.#.......#.#
#.#..##.##..#
#.#......#..#
#.##........#
#....#...#@##
#############